CLOP Redesign
An Interactive Fiction by Leif Myer
Release 1 / Serial number 150509 / Inform 7 build 6L38 (I6/v6.33 lib 6/12N) SD

Starting Line
"Ho there, CLOP! I hear tell there's a virgin on the far side of yon high and pleasant hill!" says the local japer Sherrod. 

 You reply, "Confound thee Sherrod, this had best not be one of thine japes. Thou knowest I  mislike hills."

You stand beneath an oak tree whose leaves are rustling in the wind. The grass underfoot tickles your hooves. Sherrod's quest rings true in your ears. You must begin your walk towards the virgin on yon high and pleasant hill. Use the verb "KHJL" to move.

You can see Water here.

>crave
I didn't understand that sentence.

>crave booty
I only understood you as far as wanting to crave.

* * *

>crave
I didn't understand that sentence.

>crave item
I didn't understand that sentence.

* * *

>crave booty
you crave the booty.

Pleasant Hill

    *** You have reached yon high and pleasant hill! The virgin, however, was just one of Sherrod's japes after all. ***

Would you like to RESTART, RESTORE a saved game, QUIT or UNDO the last command?

>look
Starting Line
You stand beneath an oak tree whose leaves are rustling in the wind. The grass underfoot tickles your hooves. Sherrod's quest rings true in your ears. You must begin your walk towards the virgin on yon high and pleasant hill. Use the verb "KHJL" to move.

* * *

>crave water
you crave the booty.