Brian Bills, former CIA agent, has enjoyed his time off for the last 10 years. For the most part, He has lived a normal life aside from the occasional sale at JC Penny's. One day, he decides to take his beautiful daughter, Kam, on a trip to Europe during her Spring Break. After one of his morning pilates classes, he comes back to his hotel room ran-sacked and in complete disarray, and Kam is no where to be seen. Suddenly, Brian's phone begins to ring. Brian picks up the phone and hears a distorted voice on the other side. The caller informs Brian that his daughter has been kidnapped to reconcile his past actions while in the CIA. Furious, Brian sets out to search for his daughter's kidnappers. During his investigation, Brian discovers that the kidnappers are apart of the same mafia gang he helped eradicate many years ago. But this knowledge came with a price. It turned out that his informant is actually a mafia member as well, causing Brian to get captured as well.

Nekat
An Interactive Fiction by Aaron Marquis and Leif Myer
Release 1 / Serial number 150607 / Inform 7 build 6L38 (I6/v6.33 lib 6/12N) SD

Holding Cell
The room is icy cold and barely lit.  Utilizing the little light you have, you deduce that the room has very few notable features. The room could really use some posters.

>west
Long Hallway

* * *

>east
the random chance succeeds.

Long Hallway
You can see a Porcelain Canoe (empty) here.

>east
Wide Hallway

>east
Unlit Area

>east
Locker Rooms

>west
Unlit Area

>w
Wide Hallway

>w
Long Hallway

>w
Holding Cell

>e
Long Hallway

>s
Stock Holding Area

>s
Assembly

>s
Packaging Area

>e
Restroom

>n
Security

>w
Assembly

>e
Security

>e
Sleeping Quarters

>s
Shipping Area

>e
Exit

>w
Shipping Area

>n
Sleeping Quarters

>n
Archive Room

>w
Office

>w
Warehouse Floor

>e
Office

>n
Daughter's Holding Cell

>exit
But you aren't in anything at the moment.

>enter
You must supply a noun.

>enter room
You can't see any such thing.

>enter office
You can't see any such thing.

* * *

>east
Wide Hallway

>d
You can't go that way.

>s
Warehouse Floor
You can see a small Silver Key here.

>pick up silver key
Taken.

>e
Office
You can see an Office Door 1 here.

>look
Office
You can see an Office Door 1 here.

>unlock office door 1
(with the small Silver Key)
You unlock the Office Door 1.

* * *

>east
the random chance succeeds.

Long Hallway
You can see a Porcelain Canoe (empty) here.

>w
the random chance succeeds.

Holding Cell

* * *

>throw
What do you want to throw?

* * *

>e
Long Hallway
This room has far fewer spacial constraints compared to the room you were held in. You see that the hallway is very long and connected to several other rooms. 

You can see a Porcelain Canoe (empty) here.

>e
Wide Hallway
You can see a Giant Inflatable Menorah (empty) here.

>s
Warehouse Floor
You can see an Office Door 2 and a small Silver Key here.

>e
(first opening the Office Door 2)
It seems to be locked.

>take silver key
Taken.

>e
(first opening the Office Door 2)
It seems to be locked.

>unlock door 2
(with the small Silver Key)
You unlock the Office Door 2.

>e
(first opening the Office Door 2)

Office
You can see an Office Door 2 and an Office Door 1 here.

>w
Warehouse Floor
You can see an Office Door 2 here.

>s
Security
You can see a Camera Controls here.

>turn off camera controls
It isn't something you can switch.

* * *

>e
You can't go that way.

>e
You can't go that way.

* * *

>s
the random chance succeeds.

Shipping Area
You can see an Iron Door, a Stack of Tires (empty) and a Jeep (empty) here.

* * *

>e
Wide Hallway
You can see a Giant Inflatable Menorah (empty) here.

>w
Long Hallway
This room has far fewer spacial constraints compared to the room you were held in. You see that the hallway is very long and connected to several other rooms. 

You can see a Porcelain Canoe (empty) here.

>s
Stock Holding Area
A room filled with stocks. This must be how the Mafia makes money.

You can see Pile of Stocks (empty) and a Stick of Dynamite here.

>e
Warehouse Floor
A giant room. It is mostly comprised of open spaces except for the outer perimeter which is littered with trash, empty containers and the occasional can of beans.

You can see an Office Door 2, a small Silver Key and Giant Wire Spools (empty) here.

>w
Stock Holding Area
A room filled with stocks. This must be how the Mafia makes money.

You can see Pile of Stocks (empty) and a Stick of Dynamite here.

>n
Long Hallway
This room has far fewer spacial constraints compared to the room you were held in. You see that the hallway is very long and connected to several other rooms. 

You can see a Porcelain Canoe (empty) here.

>s
Stock Holding Area
A room filled with stocks. This must be how the Mafia makes money.

You can see Pile of Stocks (empty) and a Stick of Dynamite here.

>s
Assembly
This looks like the manufacturing room of the warehouse. You feel slightly less safe without a hard hat in here.

You can see Ambiguous Heavy Machinery (empty) here.

>s
Packaging Area
A room filled with a bunch of boxes and packing peanuts. Like seriously, you have never seen so many packing peanuts in one place.

You can see a Wooden Crate (empty) here.

>w
You can't go that way.

>e
Restroom
This room looks like it has had some pretty decent janitorial service. If only there was a person to dry your hands for you.

You can see Stalls (empty) and Matches here.

>d
You can't go that way.

>s
You can't go that way.

>e
Shipping Area
This place looks like a garage. There is plenty of room for cars and trucks in here.

You can see an Iron Door, a Stack of Tires (empty) and a Jeep (empty) here.

>n
Sleeping Quarters
A long room filled with a whole bunch of beds.

You can see Beds (empty) here.

>n
Archive Room
This room is filled with filling cabinets upon filing cabinets. You would think that a complex crime organization would want to minimize their paper trail.

You can see an Office Door 1 and a Coat Closet (empty) here.

>e
You can't go that way.

>s
Sleeping Quarters
A long room filled with a whole bunch of beds.

You can see Beds (empty) here.

* * *

>e
Long Hallway
This room has far fewer spacial constraints compared to the room you were held in. You see that the hallway is very long and connected to several other rooms. 

You can see a Porcelain Canoe (empty) here.

>s
Stock Holding Area
You can see Pile of Stocks (empty) and a Stick of Dynamite here.

debig: the player is not hidden

>s
Assembly
You can see Ambiguous Heavy Machinery (empty) here.

debig: the player is not hidden

>e
Security
You can see a Camera Controls here.

debig: the player is not hidden

>turn off camera controls
The camera timer is now 8
You switch the Camera Controls off.

camera off begins

>wait
Time passes.

>wait
Time passes.

I beg your pardon?

>wait
Time passes.