Learning Inform
An Interactive Fiction by Leif Myer
Release 1 / Serial number 150503 / Inform 7 build 6L38 (I6/v6.33 lib 6/12N) SD

bedroom
Itesm litter the floor. It is very messy.

You can see Pants here.

>look
bedroom
Itesm litter the floor. It is very messy.

You can see Pants here.

>talk
That's not a verb I recognise.

>examine
What do you want to examine?

>look
bedroom

>go
You'll have to say which compass direction to go in.

>n
You can't go that way.

* * *

>look
bedroom
Itesm litter the floor. It is very messy.

You can see Pants here.

>take pants
Taken.

>look
bedroom
Itesm litter the floor. It is very messy.

>drop pants
Dropped.

>examine pants
The pants are ugly as fuck.

>west
kitchen
You can see a spoon and a stove here.

>take stove
Taken.

>look
kitchen
You can see a spoon here.

* * *

Learning Inform
An Interactive Fiction by Leif Myer
Release 1 / Serial number 150503 / Inform 7 build 6L38 (I6/v6.33 lib 6/12N) SD

bedroom
Itesm litter the floor. It is very messy.

You can see Pants here.

>examine pants
The pants are ugly as fuck.

* * *

Learning Inform
An Interactive Fiction by Leif Myer
Release 1 / Serial number 150503 / Inform 7 build 6L38 (I6/v6.33 lib 6/12N) SD

bedroom
Itesm litter the floor. It is very messy.

You can see Pants here.

>w
kitchen
You can see a spoon and a stove here.

>e
bedroom
Itesm litter the floor. It is very messy.

You can see Pants here.

* * *

>w
kitchen
You can see a spoon and a stove here.

>examine stove
A beaten up chunk of metal. Not very exciting.

* * *

Learning Inform
An Interactive Fiction by Leif Myer
Release 1 / Serial number 150503 / Inform 7 build 6L38 (I6/v6.33 lib 6/12N) SD

bedroom
Itesm litter the floor. It is very messy.

You can see Pants here.

>e
going to the wing
East Wing
Paints from 175908 to 3246389 decorate the walls.

>w
Lobby
Various displays are positioned in equal space from a centered exhibit.

You can see a George Washington display, some Money and a Candy Bar here.

>w
kitchen
You can see a spoon and a stove here.

>w
You can't go that way.

>exit
But you aren't in anything at the moment.

>leave
But you aren't in anything at the moment.

* * *

>w
Lobby
Various displays are positioned in equal space from a centered exhibit.

You can see a George Washington display, some Money and a Candy Bar here.

>take candy bar
No one will miss this.

Taken.

>e
going to the wing
You walked through the doorway but are now in the same room again.

* * *

Learning Inform
An Interactive Fiction by Leif Myer
Release 1 / Serial number 150503 / Inform 7 build 6L38 (I6/v6.33 lib 6/12N) SD

bedroom
Itesm litter the floor. It is very messy.

You can see Pants here.

>take money
Probably shouldn't take it because it's fake.

>look
Lobby
Various displays are positioned in equal space from a centered exhibit.

You can see a George Washington display and a Candy Bar here.

>drop money
Dropped.

>look
Lobby
Various displays are positioned in equal space from a centered exhibit.

You can see some Money, a George Washington display and a Candy Bar here.

>tak candy bar
That's not a verb I recognise.

>take candy bar
No one will miss this.

Taken.

>i
You are carrying:
  a Candy Bar

* * *

>take money
Probably shouldn't take it because it's fake.

>l
Lobby
Various displays are positioned in equal space from a centered exhibit.

You can see a George Washington display, some Money and a Candy Bar here.

>e
East Wing
Paints from 175908 to 3246389 decorate the walls.

>e
You can't go that way.

>w
Lobby
Various displays are positioned in equal space from a centered exhibit.

You can see a George Washington display, some Money and a Candy Bar here.

>e
East Wing
Paints from 175908 to 3246389 decorate the walls.

>l
East Wing
Paints from 175908 to 3246389 decorate the walls.

>take candy bar
You can't see any such thing.

>drop candy bar
You can't see any such thing.

>l
East Wing
Paints from 175908 to 3246389 decorate the walls.

>w
Lobby
Various displays are positioned in equal space from a centered exhibit.

You can see a George Washington display, some Money and a Candy Bar here.