Carrot Simulator
An Interactive Fiction by Leif Myer
Release 1 / Serial number 150510 / Inform 7 build 6L38 (I6/v6.33 lib 6/12N) SD

You cannot see anything because carrots don't have eyes. Try rolling to get a feel for the area.

>me
That's not a verb I recognise.

>fuck
That's not a verb I recognise.

* * *

Carrot Simulator
An Interactive Fiction by Leif Myer
Release 1 / Serial number 150510 / Inform 7 build 6L38 (I6/v6.33 lib 6/12N) SD

You cannot see anything because carrots don't have eyes. Try rolling to get a feel for the area.

>north
w33d

>south
Underground

>look
Ground

* * *

>south
Underground

>as;dfhaelrfasdfkj;
That's not a verb I recognise.

* * *

>north
w33d

>sout
That's not a verb I recognise.

>south
Underground

* * *

Carrot Simulator
An Interactive Fiction by Leif Myer
Release 1 / Serial number 150510 / Inform 7 build 6L38 (I6/v6.33 lib 6/12N) SD

You cannot see anything because carrots don't have eyes. Try rolling to get a feel for the area.

>l
Simulation Start
Welcome to Carrot Simulator 2015, the only simulation where you can live out your dreams of being a carrot. There are plently of adventures to be had in the realm of carrot simulation. Up ahead you notice two doors. The door closer to the east side of the room has a sign that says "Turnip Door". The door closer to the west side of the room has a picture of a carrot on it.
This is where you must put all your training to the test, which door do you choose?

You can see a Carrot Door and a Turnip Door here.

>s
wood door

* * *

>l
Simulation Start
Welcome to Carrot Simulator 2015, the only simulation where you can live out your dreams of being a carrot. There are plently of adventures to be had in the realm of carrot simulation. Up ahead you notice two doors. The door closer to the east side of the room has a sign that says "Turnip Door". The door closer to the west side of the room has a picture of a carrot on it.
This is where you must put all your training to the test, which door do you choose?

You can see a Carrot Door and a Turnip Door here.

>open turnip door
This is Carrot Simulator. Going through the Turnip Door would just be silly.

>examine turnip
Sounds like they are having a party in there...

>examine carrot
A simple wood door with a picture of a carrot on it. As a fellow carrot enthusiast, you feel like you should open this door.

>open carrot door
You open the Carrot Door.

>in carrot door
I only understood you as far as wanting to (go) in.

>go carrot door
Underground
After rolling through the door you find yourself underground. It is very hard to see and the dirt is making is hard to move.

You can see a Carrot Door, Water and Roots (in which is Fiber) here.

>look
You cannot see anything because carrots don't have eyes.

>east
Simulation Start
Welcome to Carrot Simulator 2015, the only simulation where you can live out your dreams of being a carrot. There are plently of adventures to be had in the realm of carrot simulation. Up ahead you notice two doors. The door closer to the east side of the room has a sign that says "Turnip Door". The door closer to the west side of the room has a picture of a carrot on it.
This is where you must put all your training to the test, which door do you choose?

You can see a Carrot Door and a Turnip Door here.

>west
Underground
After rolling through the door you find yourself underground. It is very hard to see and the dirt is making is hard to move.

You can see a Carrot Door, Water and Roots (in which is Fiber) here.

* * *

Carrot Simulator
An Interactive Fiction by Leif Myer
Release 1 / Serial number 150510 / Inform 7 build 6L38 (I6/v6.33 lib 6/12N) SD

You cannot see anything because carrots don't have eyes. Try rolling to get a feel for the area.

>look
Simulation Start
Welcome to Carrot Simulator 2015, the only simulation where you can live out your dreams of being a carrot. There are plently of adventures to be had in the realm of carrot simulation. Up ahead you notice two doors. The door closer to the east side of the room has a sign that says "Turnip Door". The door closer to the west side of the room has a picture of a carrot on it.
This is where you must put all your training to the test, which door do you choose?

You can see a Carrot Door and a Turnip Door here.

>left
That's not a verb I recognise.

>go left
You can't see any such thing.

>right
That's not a verb I recognise.

>Up
You can't go that way.

* * *

>look
Simulation Start
Welcome to Carrot Simulator 2015, the only simulation where you can live out your dreams of being a carrot. There are plently of adventures to be had in the realm of carrot simulation. Up ahead you notice two doors. The door closer to the east side of the room has a sign that says "Turnip Door". The door closer to the west side of the room has a picture of a carrot on it.
This is where you must put all your training to the test, which door do you choose?

You can see a Carrot Door and a Turnip Door here.

>west
(first opening the Carrot Door)

Underground
After rolling through the door you find yourself underground. It is very hard to see and the dirt is making is hard to move.

You can see a Carrot Door, Water and Roots (in which is Fiber) here.

>look
someofdaldfj

I beg your pardon?

* * *

>west
(first opening the Carrot Door)

Underground
After rolling through the door you find yourself underground. It is very hard to see and the dirt is making is hard to move.

You can see a Carrot Door, Water and Roots (in which is Fiber) here.

>take water
Taken.

>put water in roots
You put Water into Roots.

>take fiber
Taken.

>up
Surface
You can feel the warmth of the sun. This is a lot better than being cramped underground.

You can see Cotton Candy, Carrot Friends, Carrot-cature and Carrot Container (closed) here.

>take cotton candy
I would be wary about approaching the cotton candy. Your ancestors have told stories about carrots never returning after interacting with cotton candy.

>take carrot friends
You're a monster, why would you want to kidnap your friends?
Maybe talking to them would be more beneficial.

>talk carrot friends
That's not a verb I recognise.

* * *

>look
Simulation Start
Welcome to Carrot Simulator 2015, the only simulation where you can live out your dreams of being a carrot. There are plently of adventures to be had in the realm of carrot simulation. Up ahead you notice two doors. The door closer to the east side of the room has a sign that says "Turnip Door". The door closer to the west side of the room has a picture of a carrot on it.
This is where you must put all your training to the test, which door do you choose?

You can see a Carrot Door and a Turnip Door here.

>examine room
You can't see any such thing.

>examine door
Which do you mean, the Carrot Door or the Turnip Door?

>examine carrot door
You see nothing special about the Carrot Door.

>help
That's not a verb I recognise.

* * *

Carrot Simulator
An Interactive Fiction by Leif Myer
Release 1 / Serial number 150510 / Inform 7 build 6L38 (I6/v6.33 lib 6/12N) SD

You cannot see anything because carrots don't have eyes. Try rolling to get a feel for the area.

>right
You must supply a noun.

>right now
I only understood you as far as wanting to right.

>go right
You can't see any such thing.

* * *

Carrot Simulator
An Interactive Fiction by Leif Myer
Release 1 / Serial number 150510 / Inform 7 build 6L38 (I6/v6.33 lib 6/12N) SD

You cannot see anything because carrots don't have eyes. Try rolling to get a feel for the area.

>go right
You can't see any such thing.

>go n
You can't go that way.

* * *

Carrot Simulator
An Interactive Fiction by Leif Myer
Release 1 / Serial number 150510 / Inform 7 build 6L38 (I6/v6.33 lib 6/12N) SD

You cannot see anything because carrots don't have eyes. Try rolling to get a feel for the area.

>open turnip
This is Carrot Simulator. Going through the Turnip Door would just be silly.

>turnip
That's not a verb I recognise.

>turnip door
That's not a verb I recognise.

* * *

>open turnip
This is Carrot Simulator. Going through the Turnip Door would just be silly.

>open carrot door
You open the Carrot Door.

>go in carrot door
Underground
After rolling through the door you find yourself underground. It is very hard to see and the dirt is making is hard to move.

You can see a Carrot Door, Water and Roots (in which is Fiber) here.

>take water
Taken.

>put water in roots
Placing both the water and fiber in the roots has started a chain reaction. Through the magic of agriculture, the water has increased the power of fiber to 9000. Fiber this strong is very valuable to a carrot.
You feel sunlight on you velvety skin. Perhaps you can find the strength within you to travel up.

>take fiber
Taken.

* * *

>up
Surface
You can feel the warmth of the sun. This is a lot better than being cramped underground.

You can see Cotton Candy, Carrot Friends, Carrot-cature and Carrot Container (closed) here.

>put fiber in container
Carrot Container is closed.

>ope ncontainer
That's not a verb I recognise.

>open container
You open Carrot Container.

>put fiber in container
*** gg. ***

Would you like to RESTART, RESTORE a saved game, QUIT or UNDO the last command?

* * *

Carrot Simulator
An Interactive Fiction by Leif Myer
Release 1 / Serial number 150510 / Inform 7 build 6L38 (I6/v6.33 lib 6/12N) SD

You cannot see anything because carrots don't have eyes. Try rolling to get a feel for the area.

>east
This is Carrot Simulator. Going through the Turnip Door would just be silly.

>l
Simulation Start
Welcome to Carrot Simulator 2015, the only simulation where you can live out your dreams of being a carrot. There are plently of adventures to be had in the realm of carrot simulation.

Up ahead you notice two doors. The door closer to the east side of the room has a sign that says "Turnip Door". The door closer to the west side of the room says "Carrot Door".
This is where you must put all your training to the test, which door do you choose?

You can see a Turnip Door here.

>east
(first opening the Turnip Door)
you do not belong here.

>open door
you do not belong here.

* * *

>east
This is Carrot Simulator. Going through the Turnip Door would just be silly.

>open turnip
This is Carrot Simulator. Going through the Turnip Door would just be silly.

>west
(first opening the Carrot Door)

Underground
After rolling through the door you find yourself underground. It is very hard to see and the dirt is making is hard to move.

You can see a Carrot Door, Water and Roots (in which is Fiber) here.

>east
You struggle to reach for the door because there is so much dirt in the way. Also you are a carrot and don't have hands.

* * *

Carrot Simulator
An Interactive Fiction by Leif Myer
Release 1 / Serial number 150510 / Inform 7 build 6L38 (I6/v6.33 lib 6/12N) SD

You cannot see anything because carrots don't have eyes. Try rolling to get a feel for the area.

>open carrot door
You open the Carrot Door.

>west
Underground
After rolling through the door you find yourself underground. It is very hard to see and the dirt is making is hard to move.

You can see a Carrot Door, Water and Roots (in which is Fiber) here.

>open carrot door
That's already open.

* * *

>west
Underground
After rolling through the door you find yourself underground. It is very hard to see and the dirt is making is hard to move.

You can see a Carrot Door, Water and Roots (in which is Fiber) here.

>take water
Taken.

>put water in roots
Placing both the water and fiber in the roots has started a chain reaction. Through the magic of agriculture, the water has increased the power of fiber to 9000. Fiber this strong is very valuable to a carrot.
You feel sunlight on your velvety skin. Perhaps you can find the strength within you to travel up.

>take fiber
Taken.

* * *

>up
Surface
You can feel the warmth of the sun. This is a lot better than being cramped underground.

You can see Cotton Candy, Carrot Friends, Carrot-cature and Carrot Container (closed) here.

>put fiber in carrot container
Carrot Container is closed.

>open carrot container
You open Carrot Container.

>put fiber in carrot container
*** YOU WIN:
With the fiber secured in the Carrot Container, you turn with you head held high. You made you carrot nation proud today. The little carrot children will tell stories of your bravery. Perhaps they will even make a cool movie from your adventure staring Dwayne "The Carrot" Johnson. It's a nice thought but there are other matters to attend to. You perish these thoughts of muscular carrots and mount your horse to ride off into the sunset. Well done. ***

Would you like to RESTART, RESTORE a saved game, QUIT or UNDO the last command?

* * *

>in carrot door
I only understood you as far as wanting to (go) in.

>go carrot door
Underground
You can see a Carrot Door here.

* * *

Carrot Simulator
An Interactive Fiction by Leif Myer
Release 1 / Serial number 150510 / Inform 7 build 6L38 (I6/v6.33 lib 6/12N) SD

You cannot see anything because carrots don't have eyes. Try rolling to get a feel for the area.

>examine self
You are a carrot.

>examine self
As good-looking as ever.

* * *

>examine self
You are a carrot.

>examine door
Which do you mean, the Carrot Door or the Turnip Door?

>examine carrot door
You are a carrot.

* * *

Carrot Simulator
An Interactive Fiction by Leif Myer
Release 1 / Serial number 150510 / Inform 7 build 6L38 (I6/v6.33 lib 6/12N) SD

You cannot see anything because carrots don't have eyes. Try rolling to get a feel for the area.

>exmaine self
That's not a verb I recognise.

>examine self
you are a carrot.

* * *

Carrot Simulator
An Interactive Fiction by Leif Myer
Release 1 / Serial number 150510 / Inform 7 build 6L38 (I6/v6.33 lib 6/12N) SD

You cannot see anything because carrots don't have eyes. Try rolling to get a feel for the area.

>west
(first opening the Carrot Door)

Underground
After rolling through the door you find yourself underground. It is very hard to see and the dirt is making is hard to move.

You can see a Carrot Door, Water and Roots (in which is Fiber) here.

* * *

>look
someofdaldfj

>roots
That's not a verb I recognise.

>open root
You can't see any such thing.

>open roots
You can't see any such thing.

* * *

>take water
Taken.

>i
You are carrying:
  Water

* * *

>put water in roots
Placing both the water and fiber in the roots has started a chain reaction. Through the magic of agriculture, the water has increased the power of fiber to 9000. Fiber this strong is very valuable to a carrot.
You feel sunlight on you velvety skin. Perhaps you can find the strength within you to travel up.

>look
You cannot see anything because carrots don't have eyes.

>take water
Taken.

* * *

>put fiber in container
Carrot Container is closed.

>open container
You open Carrot Container.

>put fiber in container
*** YOU WIN:
With the fiber secured in the Carrot Container, you turn with you head held high. You made you carrot nation proud today. You then mount your horse and ride off into the sunset. Well done. ***

Would you like to RESTART, RESTORE a saved game, QUIT or UNDO the last command?

* * *

>west
(first opening the Carrot Door)

Underground
After rolling through the door you find yourself underground. It is very hard to see and the dirt is making is hard to move.

You can see a Carrot Door, Water and Roots (in which is Fiber) here.

>close roots
It isn't something you can close.

>take water
Taken.

>put water in root
You can't see any such thing.